0 1 6 -1 -6
1 2 -7 5 1
1 3 8 -1 5
1 4 -8 4 -4
2 3 -1 1 4
3 6 3 7 -6
5 6 4 2 -8
