0 5 0 -8 -4
1 2 -8 1 -9
2 3 -5 -8 8
2 5 9 -4 -3
2 7 -9 -1 2
3 7 7 0 1
4 7 -3 9 -1
6 7 5 1 5
