0 4 -5 5 -5
1 2 6 3 4
2 3 8 -1 -6
2 5 -5 2 -1
3 5 8 -6 -4
4 5 -1 -3 3
